LHHHHHHHHHHHHHHHHHHHR
#                   #
#  LH   HHHH    HR  #
#  #             #  #
#  #             #  #
#                   #
#  LH  HHHHHHH  HR  #
#  #             #  #
#       LHHHR       #
#  #    #ooo#    #  #
#  #    #ooo#    #  #
#  #    #ooo#    #  #
#       GHHHD       #
#  #             #  #
#  GH  HHHHHHH  HD  #
#        3->        #
#  #             #  #
#  #             #  #
#  GH    HHH    HD  #
#                   #
GHHHHHHHHHHHHHHHHHHHD
